1111111111111111111111111111
10000C00000000C000000000P001
10000000001000C0000000000001
10000100000000C0000000000001
10000000001000C0000100000001
1E000000000000C0000000000001
1111111111111111111111111111
