1111111111111111111111111111
100000000000000000000000P001
1000000000000000000000000001
10000000000000C0000000000001
100000E000000000000000000001
1000000000000000000000000001
1111111111111111111111111111
