1111111111111111111111111111
100000000000000000000P000001
1000C000010000C0000000000001
1000000000000000000000000001
100000C000100000000100000001
10E0000000000000000000000001
1111111111111111111111111111
